Inglés	Español	Alemán
Abiathar Abiatar
Abijah	Abias	Abija
Asa	Asa	Asa
Abiud	Abiud	Abihud
Abraham  Abraham
Achim	Aquim	Achim
Akeldama	Acéldama	Hakeldamach
Alpheus Alfeo
Ahaz	Acaz	Ahas
Amminadab	Aminadab	Amminadab
Amon	Amón	Amos
Andrew	Andrés
Aneas	Eneas
Archelaus	Arquelao	Archelaus
Azor	Azor	Azor
Azotus	Azoto
Barabbas	Barrabás
Barachiah	Berequías
Barnabas	Bernabé
Bartholomew Bartolomé
Bethesda	...	Betesda
Bethsaida 	Betsaida
Bethsphage 	Betfagé
Blastus	Blasto
Boaz	Booz	Boas
Caiaphas	Caifás
Cana	Caná	Kana
Capernaum	Capernaum	Kafarnaum
Cephas	Cefas
Chorazin	Corazín
Clopas		Clofas
Cyrene		Cirenea
Eleazar	Eleazar	Eleasar
Eliakim	Eliaquim	Eljakim
Elijah	Elías
Eliud	Eliud	Eliud
Elisha  Eliseo
Ephraim	Efraín
Gadarenes (deutsch y español Gerasa)
Gennesaret	Genesaret
Gergesenes  Gadara (deutsch y español)
Golgotha	Golgota
Hezekiah	Ezequias	Hiskija
Hezron	Esrom	Hezron
Jacob	Jacob	Jakob
Jairus 	Jairo
James	Santiago - esv dice en hechos 12,2 Jacobo
Jechoniah	Jeconías	Jojachin
Jehoshaphat	Josafat	Joschafat
Jericho	Jericó
Jesse	Isaí 	Isai
Joanna	Juana
John	Juan
Jonah	Juan 	Johannes
Joppa	Jope
Joram	Joram	Joram
Jotham	Jotam	Jotam
Joseph	José
Josiah	Josías	Joschija
Judah	Judá	Juda
Kidron	Cedrón	Kidron
Isaiah Isaías 	Jesaja
Lydda	Lida
Lukas	Lucas
Malchus	Malco
Manasseh	Manasés	Manasse
Magdala	Magadán	Magadan
Markus	Marcos
Martha	Marta
Mary	Maria
Mary Magdalene 	Maria Magdalena
Matthan	Matán	Matan
Matthew	Mateo
Midian	Madián
Moses  Moisés 
Nahshon	Naasón	Nachschon
Naphtali	Neftalí	Naftali
Nazareth Nazaret
Nineveh	Ninive
Noah	Noé
Perez	Fares	Perez
Philip	Felipe
Ram	Aram	Aram
Ramah	Ramá	Rama
Rehoboam	Roboam	Rehabeam
Rhoda	Rode
Ruth	Rut	Rut
Sadoc	Sadoc	Zadok
Salamis	Salamina
Salmon	Salmón	Salmon
Sharon	Sarón
Shealtiel	Salatiel	Schealtiël
Sidon	Sidón
Siloam	Siloé	Schiloach
Simon	Simón
Sodom	Sodoma
Solomon	Salomón	Salomo
Sychar	Sicar
Thomas	Tomas
Tyre	Tiro
Uriah	Urias	Urija
Uzziah	Uzias	Usija
Zerah	Zara	Serach	
Zacchaeus	Zaqueo
Zacharias	Zacarias
Zarephath	Sarepta
Zebedee	Zebedeo Zebedäus
Zebulun	Zabulón	Sebulon
Zerubbabel	Zerobabel	Serubbabel
Zion	Sión
